5,15,15,15,15,15,15,15,15,15,15,15,15,15,15,15,15,15,15,15,15,15,15,15,5
23,0,1,2,0,1,2,0,16,2,0,1,2,0,1,2,0,1,2,0,1,2,0,1,11
23,6,7,8,6,7,8,6,7,8,6,7,8,6,7,8,6,7,8,6,7,8,6,7,11
23,12,13,14,12,13,14,12,13,14,12,13,14,12,13,14,12,13,14,12,13,14,12,13,11
23,17,17,17,17,17,17,17,17,17,17,17,17,17,17,17,17,17,17,17,17,17,17,17,11
23,17,17,17,17,17,17,17,17,17,17,17,17,17,17,17,17,17,17,17,17,17,17,17,11
23,17,17,17,17,17,17,17,17,17,17,17,17,17,17,17,17,17,17,17,17,17,17,17,11
23,17,17,17,17,17,17,17,17,17,17,17,17,17,17,17,17,17,17,17,17,17,17,17,11
23,17,17,17,17,17,17,17,17,17,17,17,17,17,17,17,17,17,17,17,17,17,17,17,11
23,17,17,17,17,17,17,17,17,17,17,3,4,17,17,17,17,17,17,17,17,17,17,17,11
23,17,17,17,3,4,17,17,17,17,17,9,10,17,17,17,17,17,17,17,17,17,17,17,11
23,17,17,17,9,10,17,17,17,17,17,17,17,17,17,17,17,17,17,17,17,17,17,17,11
23,17,17,17,17,17,17,17,17,17,17,17,17,17,17,17,17,17,17,17,17,17,17,17,11
23,17,17,17,17,17,17,17,17,17,17,17,17,17,17,17,17,17,17,17,17,17,17,17,11
23,17,17,17,17,17,17,17,17,17,17,17,17,17,17,17,17,17,17,17,17,17,17,17,11
23,17,17,17,17,17,17,17,17,17,17,17,17,17,17,17,17,17,17,17,17,17,17,17,11
23,17,17,17,17,17,17,17,17,17,17,17,17,17,17,17,17,17,17,17,17,17,17,17,11
23,3,4,17,17,17,17,17,17,17,17,17,17,17,17,17,17,17,17,17,17,17,17,17,11
23,9,10,17,17,17,17,17,17,17,17,17,17,17,17,17,17,17,17,17,17,17,17,17,11
5,22,22,22,22,22,22,22,22,22,22,22,22,22,22,22,22,22,22,22,22,22,22,22,5
